id	group	priority
#campaign_group_members_tables;1;db/campaign_group_members_tables/jiangshi_reborn+		
jiangshi_DLC11_diplomacy_Subcult_VampireCoast_&_OtherFactionVamp	DLC11_diplomacy_Subcult_VampireCoast_&_OtherFactionVamp	0.0000
jiangshi_DLC11_diplomacy_Subcult_VampireCoast_&_OtherFactionVamp_&_Negative	DLC11_diplomacy_Subcult_VampireCoast_&_OtherFactionVamp_&_Negative	0.0000
jiangshi_DLC11_diplomacy_Subcult_VampireCoast_&_OtherFactionVamp_&_Positive	DLC11_diplomacy_Subcult_VampireCoast_&_OtherFactionVamp_&_Positive	0.0000
jiangshi_diplomacy_Faction_Alarielle_&_OtherFactionVamp	diplomacy_Faction_Alarielle_&_OtherFactionVamp	0.0000
jiangshi_diplomacy_Faction_Alarielle_&_OtherFactionVamp_&_Negative	diplomacy_Faction_Alarielle_&_OtherFactionVamp_&_Negative	0.0000
jiangshi_diplomacy_Faction_Alarielle_&_OtherFactionVamp_&_Positive	diplomacy_Faction_Alarielle_&_OtherFactionVamp_&_Positive	0.0000
jiangshi_diplomacy_Faction_Alith_Anar_&_OtherFactionVamp	diplomacy_Faction_Alith_Anar_&_OtherFactionVamp	0.0000
jiangshi_diplomacy_Faction_Alith_Anar_&_OtherFactionVamp_&_Negative	diplomacy_Faction_Alith_Anar_&_OtherFactionVamp_&_Negative	0.0000
jiangshi_diplomacy_Faction_Alith_Anar_&_OtherFactionVamp_&_Positive	diplomacy_Faction_Alith_Anar_&_OtherFactionVamp_&_Positive	0.0000
jiangshi_diplomacy_Faction_Archaon_&_OtherFactionVamp	diplomacy_Faction_Archaon_&_OtherFactionVamp	0.0000
jiangshi_diplomacy_Faction_Archaon_&_OtherFactionVamp_&_Negative	diplomacy_Faction_Archaon_&_OtherFactionVamp_&_Negative	0.0000
jiangshi_diplomacy_Faction_Archaon_&_OtherFactionVamp_&_Positive	diplomacy_Faction_Archaon_&_OtherFactionVamp_&_Positive	0.0000
jiangshi_diplomacy_Faction_Azhag_&_OtherFactionVamp	diplomacy_Faction_Azhag_&_OtherFactionVamp	0.0000
jiangshi_diplomacy_Faction_Azhag_&_OtherFactionVamp_&_Negative	diplomacy_Faction_Azhag_&_OtherFactionVamp_&_Negative	0.0000
jiangshi_diplomacy_Faction_Azhag_&_OtherFactionVamp_&_Positive	diplomacy_Faction_Azhag_&_OtherFactionVamp_&_Positive	0.0000
jiangshi_diplomacy_Faction_BalthasarGelt_&_OtherFactionVamp	diplomacy_Faction_BalthasarGelt_&_OtherFactionVamp	0.0000
jiangshi_diplomacy_Faction_BalthasarGelt_&_OtherFactionVamp_&_Negative	diplomacy_Faction_BalthasarGelt_&_OtherFactionVamp_&_Negative	0.0000
jiangshi_diplomacy_Faction_BalthasarGelt_&_OtherFactionVamp_&_Positive	diplomacy_Faction_BalthasarGelt_&_OtherFactionVamp_&_Positive	0.0000
jiangshi_diplomacy_Faction_Fellheart_&_OtherFactionVamp	diplomacy_Faction_Fellheart_&_OtherFactionVamp	0.0000
jiangshi_diplomacy_Faction_Fellheart_&_OtherFactionVamp_&_Negative	diplomacy_Faction_Fellheart_&_OtherFactionVamp_&_Negative	0.0000
jiangshi_diplomacy_Faction_Fellheart_&_OtherFactionVamp_&_Positive	diplomacy_Faction_Fellheart_&_OtherFactionVamp_&_Positive	0.0000
jiangshi_diplomacy_Faction_Grimgor_&_OtherFactionVamp	diplomacy_Faction_Grimgor_&_OtherFactionVamp	0.0000
jiangshi_diplomacy_Faction_Grimgor_&_OtherFactionVamp_&_Negative	diplomacy_Faction_Grimgor_&_OtherFactionVamp_&_Negative	0.0000
jiangshi_diplomacy_Faction_Grimgor_&_OtherFactionVamp_&_Positive	diplomacy_Faction_Grimgor_&_OtherFactionVamp_&_Positive	0.0000
jiangshi_diplomacy_Faction_Heinrich_&_OtherFactionVamp	diplomacy_Faction_Heinrich_&_OtherFactionVamp	0.0000
jiangshi_diplomacy_Faction_Heinrich_&_OtherFactionVamp_&_Negative	diplomacy_Faction_Heinrich_&_OtherFactionVamp_&_Negative	0.0000
jiangshi_diplomacy_Faction_Heinrich_&_OtherFactionVamp_&_Positive	diplomacy_Faction_Heinrich_&_OtherFactionVamp_&_Positive	0.0000
jiangshi_diplomacy_Faction_Hellebron_&_OtherFactionVamp	diplomacy_Faction_Hellebron_&_OtherFactionVamp	0.0000
jiangshi_diplomacy_Faction_Hellebron_&_OtherFactionVamp_&_Negative	diplomacy_Faction_Hellebron_&_OtherFactionVamp_&_Negative	0.0000
jiangshi_diplomacy_Faction_Hellebron_&_OtherFactionVamp_&_Positive	diplomacy_Faction_Hellebron_&_OtherFactionVamp_&_Positive	0.0000
jiangshi_diplomacy_Faction_KarlFranz_&_OtherFactionVamp	diplomacy_Faction_KarlFranz_&_OtherFactionVamp	0.0000
jiangshi_diplomacy_Faction_KarlFranz_&_OtherFactionVamp_&_Negative	diplomacy_Faction_KarlFranz_&_OtherFactionVamp_&_Negative	0.0000
jiangshi_diplomacy_Faction_KarlFranz_&_OtherFactionVamp_&_Positive	diplomacy_Faction_KarlFranz_&_OtherFactionVamp_&_Positive	0.0000
jiangshi_diplomacy_Faction_Kemmler_&_OtherFactionVamp	diplomacy_Faction_Kemmler_&_OtherFactionVamp	0.0000
jiangshi_diplomacy_Faction_Kemmler_&_OtherFactionVamp_&_Negative	diplomacy_Faction_Kemmler_&_OtherFactionVamp_&_Negative	0.0000
jiangshi_diplomacy_Faction_Kemmler_&_OtherFactionVamp_&_Positive	diplomacy_Faction_Kemmler_&_OtherFactionVamp_&_Positive	0.0000
jiangshi_diplomacy_Faction_Kholek_&_OtherFactionVamp	diplomacy_Faction_Kholek_&_OtherFactionVamp	0.0000
jiangshi_diplomacy_Faction_Kholek_&_OtherFactionVamp_&_Negative	diplomacy_Faction_Kholek_&_OtherFactionVamp_&_Negative	0.0000
jiangshi_diplomacy_Faction_Kholek_&_OtherFactionVamp_&_Positive	diplomacy_Faction_Kholek_&_OtherFactionVamp_&_Positive	0.0000
jiangshi_diplomacy_Faction_KroqGar_&_OtherFactionVamp	diplomacy_Faction_KroqGar_&_OtherFactionVamp	0.0000
jiangshi_diplomacy_Faction_KroqGar_&_OtherFactionVamp_&_Negative	diplomacy_Faction_KroqGar_&_OtherFactionVamp_&_Negative	0.0000
jiangshi_diplomacy_Faction_KroqGar_&_OtherFactionVamp_&_Positive	diplomacy_Faction_KroqGar_&_OtherFactionVamp_&_Positive	0.0000
jiangshi_diplomacy_Faction_LordofChange_&_OtherFactionVamp	diplomacy_Faction_LordofChange_&_OtherFactionVamp	0.0000
jiangshi_diplomacy_Faction_LordofChange_&_OtherFactionVamp_&_Negative	diplomacy_Faction_LordofChange_&_OtherFactionVamp_&_Negative	0.0000
jiangshi_diplomacy_Faction_LordofChange_&_OtherFactionVamp_&_Positive	diplomacy_Faction_LordofChange_&_OtherFactionVamp_&_Positive	0.0000
jiangshi_diplomacy_Faction_LouenLeoncoeur_&_OtherFactionVamp	diplomacy_Faction_LouenLeoncoeur_&_OtherFactionVamp	0.0000
jiangshi_diplomacy_Faction_LouenLeoncoeur_&_OtherFactionVamp_&_Negative	diplomacy_Faction_LouenLeoncoeur_&_OtherFactionVamp_&_Negative	0.0000
jiangshi_diplomacy_Faction_LouenLeoncoeur_&_OtherFactionVamp_&_Positive	diplomacy_Faction_LouenLeoncoeur_&_OtherFactionVamp_&_Positive	0.0000
jiangshi_diplomacy_Faction_Malekith_&_OtherFactionVamp	diplomacy_Faction_Malekith_&_OtherFactionVamp	0.0000
jiangshi_diplomacy_Faction_Malekith_&_OtherFactionVamp_&_Negative	diplomacy_Faction_Malekith_&_OtherFactionVamp_&_Negative	0.0000
jiangshi_diplomacy_Faction_Malekith_&_OtherFactionVamp_&_Positive	diplomacy_Faction_Malekith_&_OtherFactionVamp_&_Positive	0.0000
jiangshi_diplomacy_Faction_Mannfred_&_OtherFactionVamp	diplomacy_Faction_Mannfred_&_OtherFactionVamp	0.0000
jiangshi_diplomacy_Faction_Mannfred_&_OtherFactionVamp_&_Negative	diplomacy_Faction_Mannfred_&_OtherFactionVamp_&_Negative	0.0000
jiangshi_diplomacy_Faction_Mannfred_&_OtherFactionVamp_&_Positive	diplomacy_Faction_Mannfred_&_OtherFactionVamp_&_Positive	0.0000
jiangshi_diplomacy_Faction_Mazdamundi_&_OtherFactionVamp	diplomacy_Faction_Mazdamundi_&_OtherFactionVamp	0.0000
jiangshi_diplomacy_Faction_Mazdamundi_&_OtherFactionVamp_&_Negative	diplomacy_Faction_Mazdamundi_&_OtherFactionVamp_&_Negative	0.0000
jiangshi_diplomacy_Faction_Mazdamundi_&_OtherFactionVamp_&_Positive	diplomacy_Faction_Mazdamundi_&_OtherFactionVamp_&_Positive	0.0000
jiangshi_diplomacy_Faction_Morathi_&_OtherFactionVamp	diplomacy_Faction_Morathi_&_OtherFactionVamp	0.0000
jiangshi_diplomacy_Faction_Morathi_&_OtherFactionVamp_&_Negative	diplomacy_Faction_Morathi_&_OtherFactionVamp_&_Negative	0.0000
jiangshi_diplomacy_Faction_Morathi_&_OtherFactionVamp_&_Positive	diplomacy_Faction_Morathi_&_OtherFactionVamp_&_Positive	0.0000
jiangshi_diplomacy_Faction_Queek_&_OtherFactionVamp	diplomacy_Faction_Queek_&_OtherFactionVamp	0.0000
jiangshi_diplomacy_Faction_Queek_&_OtherFactionVamp_&_Negative	diplomacy_Faction_Queek_&_OtherFactionVamp_&_Negative	0.0000
jiangshi_diplomacy_Faction_Queek_&_OtherFactionVamp_&_Positive	diplomacy_Faction_Queek_&_OtherFactionVamp_&_Positive	0.0000
jiangshi_diplomacy_Faction_Sigvald_&_OtherFactionVamp	diplomacy_Faction_Sigvald_&_OtherFactionVamp	0.0000
jiangshi_diplomacy_Faction_Sigvald_&_OtherFactionVamp_&_Negative	diplomacy_Faction_Sigvald_&_OtherFactionVamp_&_Negative	0.0000
jiangshi_diplomacy_Faction_Sigvald_&_OtherFactionVamp_&_Positive	diplomacy_Faction_Sigvald_&_OtherFactionVamp_&_Positive	0.0000
jiangshi_diplomacy_Faction_Skrolk_&_OtherFactionVamp	diplomacy_Faction_Skrolk_&_OtherFactionVamp	0.0000
jiangshi_diplomacy_Faction_Skrolk_&_OtherFactionVamp_&_Negative	diplomacy_Faction_Skrolk_&_OtherFactionVamp_&_Negative	0.0000
jiangshi_diplomacy_Faction_Skrolk_&_OtherFactionVamp_&_Positive	diplomacy_Faction_Skrolk_&_OtherFactionVamp_&_Positive	0.0000
jiangshi_diplomacy_Faction_Teclis_&_OtherFactionVamp	diplomacy_Faction_Teclis_&_OtherFactionVamp	0.0000
jiangshi_diplomacy_Faction_Teclis_&_OtherFactionVamp_&_Negative	diplomacy_Faction_Teclis_&_OtherFactionVamp_&_Negative	0.0000
jiangshi_diplomacy_Faction_Teclis_&_OtherFactionVamp_&_Positive	diplomacy_Faction_Teclis_&_OtherFactionVamp_&_Positive	0.0000
jiangshi_diplomacy_Faction_Thorgrim_&_OtherFactionVamp	diplomacy_Faction_Thorgrim_&_OtherFactionVamp	0.0000
jiangshi_diplomacy_Faction_Thorgrim_&_OtherFactionVamp_&_Negative	diplomacy_Faction_Thorgrim_&_OtherFactionVamp_&_Negative	0.0000
jiangshi_diplomacy_Faction_Thorgrim_&_OtherFactionVamp_&_Positive	diplomacy_Faction_Thorgrim_&_OtherFactionVamp_&_Positive	0.0000
jiangshi_diplomacy_Faction_Tyrion_&_OtherFactionVamp	diplomacy_Faction_Tyrion_&_OtherFactionVamp	0.0000
jiangshi_diplomacy_Faction_Tyrion_&_OtherFactionVamp_&_Negative	diplomacy_Faction_Tyrion_&_OtherFactionVamp_&_Negative	0.0000
jiangshi_diplomacy_Faction_Tyrion_&_OtherFactionVamp_&_Positive	diplomacy_Faction_Tyrion_&_OtherFactionVamp_&_Positive	0.0000
jiangshi_diplomacy_Faction_Ungrim_&_OtherFactionVamp	diplomacy_Faction_Ungrim_&_OtherFactionVamp	0.0000
jiangshi_diplomacy_Faction_Ungrim_&_OtherFactionVamp_&_Negative	diplomacy_Faction_Ungrim_&_OtherFactionVamp_&_Negative	0.0000
jiangshi_diplomacy_Faction_Ungrim_&_OtherFactionVamp_&_Positive	diplomacy_Faction_Ungrim_&_OtherFactionVamp_&_Positive	0.0000
jiangshi_diplomacy_Faction_Vlad_&_OtherFactionVamp	diplomacy_Faction_Vlad_&_OtherFactionVamp	0.0000
jiangshi_diplomacy_Faction_Vlad_&_OtherFactionVamp_&_Negative	diplomacy_Faction_Vlad_&_OtherFactionVamp_&_Negative	0.0000
jiangshi_diplomacy_Faction_Vlad_&_OtherFactionVamp_&_Positive	diplomacy_Faction_Vlad_&_OtherFactionVamp_&_Positive	0.0000
jiangshi_diplomacy_Faction_tehenhauin_&_OtherFactionVamp	diplomacy_Faction_tehenhauin_&_OtherFactionVamp	0.0000
jiangshi_diplomacy_Faction_tehenhauin_&_OtherFactionVamp_&_Negative	diplomacy_Faction_tehenhauin_&_OtherFactionVamp_&_Negative	0.0000
jiangshi_diplomacy_Faction_tehenhauin_&_OtherFactionVamp_&_Positive	diplomacy_Faction_tehenhauin_&_OtherFactionVamp_&_Positive	0.0000
jiangshi_diplomacy_Faction_tiktaqto_&_OtherFactionVamp	diplomacy_Faction_tiktaqto_&_OtherFactionVamp	0.0000
jiangshi_diplomacy_Faction_tiktaqto_&_OtherFactionVamp_&_Negative	diplomacy_Faction_tiktaqto_&_OtherFactionVamp_&_Negative	0.0000
jiangshi_diplomacy_Faction_tiktaqto_&_OtherFactionVamp_&_Positive	diplomacy_Faction_tiktaqto_&_OtherFactionVamp_&_Positive	0.0000
jiangshi_diplomacy_Subcult_Bretonnia_&_OtherFactionVamp	diplomacy_Subcult_Bretonnia_&_OtherFactionVamp	0.0000
jiangshi_diplomacy_Subcult_Bretonnia_&_OtherFactionVamp_&_Negative	diplomacy_Subcult_Bretonnia_&_OtherFactionVamp_&_Negative	0.0000
jiangshi_diplomacy_Subcult_Bretonnia_&_OtherFactionVamp_&_Positive	diplomacy_Subcult_Bretonnia_&_OtherFactionVamp_&_Positive	0.0000
jiangshi_diplomacy_Subcult_Chaos_&_OtherFactionVamp	diplomacy_Subcult_Chaos_&_OtherFactionVamp	0.0000
jiangshi_diplomacy_Subcult_Chaos_&_OtherFactionVamp_&_Negative	diplomacy_Subcult_Chaos_&_OtherFactionVamp_&_Negative	0.0000
jiangshi_diplomacy_Subcult_Chaos_&_OtherFactionVamp_&_Positive	diplomacy_Subcult_Chaos_&_OtherFactionVamp_&_Positive	0.0000
jiangshi_diplomacy_Subcult_DarkElves_&_OtherFactionVamp	diplomacy_Subcult_DarkElves_&_OtherFactionVamp	0.0000
jiangshi_diplomacy_Subcult_DarkElves_&_OtherFactionVamp_&_Negative	diplomacy_Subcult_DarkElves_&_OtherFactionVamp_&_Negative	0.0000
jiangshi_diplomacy_Subcult_DarkElves_&_OtherFactionVamp_&_Positive	diplomacy_Subcult_DarkElves_&_OtherFactionVamp_&_Positive	0.0000
jiangshi_diplomacy_Subcult_Dwarfs_&_OtherFactionVamp	diplomacy_Subcult_Dwarfs_&_OtherFactionVamp	0.0000
jiangshi_diplomacy_Subcult_Dwarfs_&_OtherFactionVamp_&_Negative	diplomacy_Subcult_Dwarfs_&_OtherFactionVamp_&_Negative	0.0000
jiangshi_diplomacy_Subcult_Dwarfs_&_OtherFactionVamp_&_Positive	diplomacy_Subcult_Dwarfs_&_OtherFactionVamp_&_Positive	0.0000
jiangshi_diplomacy_Subcult_Empire_&_OtherFactionVamp	diplomacy_Subcult_Empire_&_OtherFactionVamp	0.0000
jiangshi_diplomacy_Subcult_Empire_&_OtherFactionVamp_&_Negative	diplomacy_Subcult_Empire_&_OtherFactionVamp_&_Negative	0.0000
jiangshi_diplomacy_Subcult_Empire_&_OtherFactionVamp_&_Positive	diplomacy_Subcult_Empire_&_OtherFactionVamp_&_Positive	0.0000
jiangshi_diplomacy_Subcult_Greenskins_&_OtherFactionVamp	diplomacy_Subcult_Greenskins_&_OtherFactionVamp	0.0000
jiangshi_diplomacy_Subcult_Greenskins_&_OtherFactionVamp_&_Negative	diplomacy_Subcult_Greenskins_&_OtherFactionVamp_&_Negative	0.0000
jiangshi_diplomacy_Subcult_Greenskins_&_OtherFactionVamp_&_Positive	diplomacy_Subcult_Greenskins_&_OtherFactionVamp_&_Positive	0.0000
jiangshi_diplomacy_Subcult_HighElves_&_OtherFactionVamp	diplomacy_Subcult_HighElves_&_OtherFactionVamp	0.0000
jiangshi_diplomacy_Subcult_HighElves_&_OtherFactionVamp_&_Negative	diplomacy_Subcult_HighElves_&_OtherFactionVamp_&_Negative	0.0000
jiangshi_diplomacy_Subcult_HighElves_&_OtherFactionVamp_&_Positive	diplomacy_Subcult_HighElves_&_OtherFactionVamp_&_Positive	0.0000
jiangshi_diplomacy_Subcult_Lizardmen_&_OtherFactionVamp	diplomacy_Subcult_Lizardmen_&_OtherFactionVamp	0.0000
jiangshi_diplomacy_Subcult_Lizardmen_&_OtherFactionVamp_&_Negative	diplomacy_Subcult_Lizardmen_&_OtherFactionVamp_&_Negative	0.0000
jiangshi_diplomacy_Subcult_Lizardmen_&_OtherFactionVamp_&_Positive	diplomacy_Subcult_Lizardmen_&_OtherFactionVamp_&_Positive	0.0000
jiangshi_diplomacy_Subcult_Norsca_&_OtherFactionVamp	diplomacy_Subcult_Norsca_&_OtherFactionVamp	0.0000
jiangshi_diplomacy_Subcult_Norsca_&_OtherFactionVamp_&_Negative	diplomacy_Subcult_Norsca_&_OtherFactionVamp_&_Negative	0.0000
jiangshi_diplomacy_Subcult_Norsca_&_OtherFactionVamp_&_Positive	diplomacy_Subcult_Norsca_&_OtherFactionVamp_&_Positive	0.0000
jiangshi_diplomacy_Subcult_Skaven_&_OtherFactionVamp	diplomacy_Subcult_Skaven_&_OtherFactionVamp	0.0000
jiangshi_diplomacy_Subcult_Skaven_&_OtherFactionVamp_&_Negative	diplomacy_Subcult_Skaven_&_OtherFactionVamp_&_Negative	0.0000
jiangshi_diplomacy_Subcult_Skaven_&_OtherFactionVamp_&_Positive	diplomacy_Subcult_Skaven_&_OtherFactionVamp_&_Positive	0.0000
jiangshi_diplomacy_Subcult_TEB_&_OtherFactionVamp	diplomacy_Subcult_TEB_&_OtherFactionVamp	0.0000
jiangshi_diplomacy_Subcult_TEB_&_OtherFactionVamp_&_Negative	diplomacy_Subcult_TEB_&_OtherFactionVamp_&_Negative	0.0000
jiangshi_diplomacy_Subcult_TEB_&_OtherFactionVamp_&_Positive	diplomacy_Subcult_TEB_&_OtherFactionVamp_&_Positive	0.0000
jiangshi_diplomacy_Subcult_Vampire	diplomacy_Subcult_Vampire	0.0000
jiangshi_diplomacy_Subcult_Vampire_&_Negative	diplomacy_Subcult_Vampire_&_Negative	0.0000
jiangshi_diplomacy_Subcult_Vampire_&_OtherFactionBretonnia	diplomacy_Subcult_Vampire_&_OtherFactionBretonnia	0.0000
jiangshi_diplomacy_Subcult_Vampire_&_OtherFactionBretonnia_&_Negative	diplomacy_Subcult_Vampire_&_OtherFactionBretonnia_&_Negative	0.0000
jiangshi_diplomacy_Subcult_Vampire_&_OtherFactionBretonnia_&_Positive	diplomacy_Subcult_Vampire_&_OtherFactionBretonnia_&_Positive	0.0000
jiangshi_diplomacy_Subcult_Vampire_&_OtherFactionChaos	diplomacy_Subcult_Vampire_&_OtherFactionChaos	0.0000
jiangshi_diplomacy_Subcult_Vampire_&_OtherFactionChaos_&_Negative	diplomacy_Subcult_Vampire_&_OtherFactionChaos_&_Negative	0.0000
jiangshi_diplomacy_Subcult_Vampire_&_OtherFactionChaos_&_Positive	diplomacy_Subcult_Vampire_&_OtherFactionChaos_&_Positive	0.0000
jiangshi_diplomacy_Subcult_Vampire_&_OtherFactionDwarf	diplomacy_Subcult_Vampire_&_OtherFactionDwarf	0.0000
jiangshi_diplomacy_Subcult_Vampire_&_OtherFactionDwarf_&_Negative	diplomacy_Subcult_Vampire_&_OtherFactionDwarf_&_Negative	0.0000
jiangshi_diplomacy_Subcult_Vampire_&_OtherFactionDwarf_&_Positive	diplomacy_Subcult_Vampire_&_OtherFactionDwarf_&_Positive	0.0000
jiangshi_diplomacy_Subcult_Vampire_&_OtherFactionEmpire	diplomacy_Subcult_Vampire_&_OtherFactionEmpire	0.0000
jiangshi_diplomacy_Subcult_Vampire_&_OtherFactionEmpire_&_Negative	diplomacy_Subcult_Vampire_&_OtherFactionEmpire_&_Negative	0.0000
jiangshi_diplomacy_Subcult_Vampire_&_OtherFactionEmpire_&_Positive	diplomacy_Subcult_Vampire_&_OtherFactionEmpire_&_Positive	0.0000
jiangshi_diplomacy_Subcult_Vampire_&_OtherFactionGreenskin	diplomacy_Subcult_Vampire_&_OtherFactionGreenskin	0.0000
jiangshi_diplomacy_Subcult_Vampire_&_OtherFactionGreenskin_&_Negative	diplomacy_Subcult_Vampire_&_OtherFactionGreenskin_&_Negative	0.0000
jiangshi_diplomacy_Subcult_Vampire_&_OtherFactionGreenskin_&_Positive	diplomacy_Subcult_Vampire_&_OtherFactionGreenskin_&_Positive	0.0000
jiangshi_diplomacy_Subcult_Vampire_&_OtherFactionVamp	diplomacy_Subcult_Vampire_&_OtherFactionVamp	0.0000
jiangshi_diplomacy_Subcult_Vampire_&_OtherFactionVamp_&_Negative	diplomacy_Subcult_Vampire_&_OtherFactionVamp_&_Negative	0.0000
jiangshi_diplomacy_Subcult_Vampire_&_OtherFactionVamp_&_Positive	diplomacy_Subcult_Vampire_&_OtherFactionVamp_&_Positive	0.0000
jiangshi_diplomacy_Subcult_Vampire_&_Positive	diplomacy_Subcult_Vampire_&_Positive	0.0000
jiangshi_diplomacy_faction_dwf_grombrindal_&_OtherFactionVamp	diplomacy_faction_dwf_grombrindal_&_OtherFactionVamp	0.0000
jiangshi_diplomacy_faction_dwf_grombrindal_&_OtherFactionVamp_&_Negative	diplomacy_faction_dwf_grombrindal_&_OtherFactionVamp_&_Negative	0.0000
jiangshi_diplomacy_faction_dwf_grombrindal_&_OtherFactionVamp_&_Positive	diplomacy_faction_dwf_grombrindal_&_OtherFactionVamp_&_Positive	0.0000
jiangshi_diplomacy_faction_emp_volkmar_&_OtherFactionVamp	diplomacy_faction_emp_volkmar_&_OtherFactionVamp	0.0000
jiangshi_diplomacy_faction_emp_volkmar_&_OtherFactionVamp_&_Negative	diplomacy_faction_emp_volkmar_&_OtherFactionVamp_&_Negative	0.0000
jiangshi_diplomacy_faction_emp_volkmar_&_OtherFactionVamp_&_Positive	diplomacy_faction_emp_volkmar_&_OtherFactionVamp_&_Positive	0.0000
jiangshi_diplomacy_faction_vmp_ghorst_&_OtherFactionVamp	diplomacy_faction_vmp_ghorst_&_OtherFactionVamp	0.0000
jiangshi_diplomacy_faction_vmp_ghorst_&_OtherFactionVamp_&_Negative	diplomacy_faction_vmp_ghorst_&_OtherFactionVamp_&_Negative	0.0000
jiangshi_diplomacy_faction_vmp_ghorst_&_OtherFactionVamp_&_Positive	diplomacy_faction_vmp_ghorst_&_OtherFactionVamp_&_Positive	0.0000
jiangshi_dlc06_diplomacy_Faction_Belegar_&_OtherFactionVamp	dlc06_diplomacy_Faction_Belegar_&_OtherFactionVamp	0.0000
jiangshi_dlc06_diplomacy_Faction_Belegar_&_OtherFactionVamp_&_Negative	dlc06_diplomacy_Faction_Belegar_&_OtherFactionVamp_&_Negative	0.0000
jiangshi_dlc06_diplomacy_Faction_Belegar_&_OtherFactionVamp_&_Positive	dlc06_diplomacy_Faction_Belegar_&_OtherFactionVamp_&_Positive	0.0000
jiangshi_dlc06_diplomacy_Faction_Skarsnik_&_OtherFactionVamp	dlc06_diplomacy_Faction_Skarsnik_&_OtherFactionVamp	0.0000
jiangshi_dlc06_diplomacy_Faction_Skarsnik_&_OtherFactionVamp_&_Negative	dlc06_diplomacy_Faction_Skarsnik_&_OtherFactionVamp_&_Negative	0.0000
jiangshi_dlc06_diplomacy_Faction_Skarsnik_&_OtherFactionVamp_&_Positive	dlc06_diplomacy_Faction_Skarsnik_&_OtherFactionVamp_&_Positive	0.0000
jiangshi_dlc06_diplomacy_Faction_Wurrzag_&_OtherFactionVamp	dlc06_diplomacy_Faction_Wurrzag_&_OtherFactionVamp	0.0000
jiangshi_dlc06_diplomacy_Faction_Wurrzag_&_OtherFactionVamp_&_Negative	dlc06_diplomacy_Faction_Wurrzag_&_OtherFactionVamp_&_Negative	0.0000
jiangshi_dlc06_diplomacy_Faction_Wurrzag_&_OtherFactionVamp_&_Positive	dlc06_diplomacy_Faction_Wurrzag_&_OtherFactionVamp_&_Positive	0.0000
jiangshi_dlc09_diplomacy_Faction_TMB_Arkhan_&_OtherFactionVamp	dlc09_diplomacy_Faction_TMB_Arkhan_&_OtherFactionVamp	0.0000
jiangshi_dlc09_diplomacy_Faction_TMB_Arkhan_&_OtherFactionVamp_&_Negative	dlc09_diplomacy_Faction_TMB_Arkhan_&_OtherFactionVamp_&_Negative	0.0000
jiangshi_dlc09_diplomacy_Faction_TMB_Arkhan_&_OtherFactionVamp_&_Positive	dlc09_diplomacy_Faction_TMB_Arkhan_&_OtherFactionVamp_&_Positive	0.0000
jiangshi_dlc09_diplomacy_Faction_TMB_Khalida_&_OtherFactionVamp	dlc09_diplomacy_Faction_TMB_Khalida_&_OtherFactionVamp	0.0000
jiangshi_dlc09_diplomacy_Faction_TMB_Khalida_&_OtherFactionVamp_&_Negative	dlc09_diplomacy_Faction_TMB_Khalida_&_OtherFactionVamp_&_Negative	0.0000
jiangshi_dlc09_diplomacy_Faction_TMB_Khalida_&_OtherFactionVamp_&_Positive	dlc09_diplomacy_Faction_TMB_Khalida_&_OtherFactionVamp_&_Positive	0.0000
jiangshi_dlc09_diplomacy_Faction_TMB_Khatep_&_OtherFactionVamp	dlc09_diplomacy_Faction_TMB_Khatep_&_OtherFactionVamp	0.0000
jiangshi_dlc09_diplomacy_Faction_TMB_Khatep_&_OtherFactionVamp_&_Negative	dlc09_diplomacy_Faction_TMB_Khatep_&_OtherFactionVamp_&_Negative	0.0000
jiangshi_dlc09_diplomacy_Faction_TMB_Khatep_&_OtherFactionVamp_&_Positive	dlc09_diplomacy_Faction_TMB_Khatep_&_OtherFactionVamp_&_Positive	0.0000
jiangshi_dlc09_diplomacy_Faction_TMB_Settra_&_OtherFactionVamp	dlc09_diplomacy_Faction_TMB_Settra_&_OtherFactionVamp	0.0000
jiangshi_dlc09_diplomacy_Faction_TMB_Settra_&_OtherFactionVamp_&_Negative	dlc09_diplomacy_Faction_TMB_Settra_&_OtherFactionVamp_&_Negative	0.0000
jiangshi_dlc09_diplomacy_Faction_TMB_Settra_&_OtherFactionVamp_&_Positive	dlc09_diplomacy_Faction_TMB_Settra_&_OtherFactionVamp_&_Positive	0.0000
jiangshi_dlc09_diplomacy_Subcult_TombKings_&_OtherFactionVamp	dlc09_diplomacy_Subcult_TombKings_&_OtherFactionVamp	0.0000
jiangshi_dlc09_diplomacy_Subcult_TombKings_&_OtherFactionVamp_&_Negative	dlc09_diplomacy_Subcult_TombKings_&_OtherFactionVamp_&_Negative	0.0000
jiangshi_dlc09_diplomacy_Subcult_TombKings_&_OtherFactionVamp_&_Positive	dlc09_diplomacy_Subcult_TombKings_&_OtherFactionVamp_&_Positive	0.0000
jiangshi_dlc11_diplomacy_Faction_CST_Harkon_&_OtherFactionVamp	dlc11_diplomacy_Faction_CST_Harkon_&_OtherFactionVamp	0.0000
jiangshi_dlc11_diplomacy_Faction_CST_Harkon_&_OtherFactionVamp_&_Negative	dlc11_diplomacy_Faction_CST_Harkon_&_OtherFactionVamp_&_Negative	0.0000
jiangshi_dlc11_diplomacy_Faction_CST_Harkon_&_OtherFactionVamp_&_Positive	dlc11_diplomacy_Faction_CST_Harkon_&_OtherFactionVamp_&_Positive	0.0000
jiangshi_dlc11_diplomacy_Faction_CST_Noctilus_&_OtherFactionVamp	dlc11_diplomacy_Faction_CST_Noctilus_&_OtherFactionVamp	0.0000
jiangshi_dlc11_diplomacy_Faction_CST_Noctilus_&_OtherFactionVamp_&_Negative	dlc11_diplomacy_Faction_CST_Noctilus_&_OtherFactionVamp_&_Negative	0.0000
jiangshi_dlc11_diplomacy_Faction_CST_Noctilus_&_OtherFactionVamp_&_Positive	dlc11_diplomacy_Faction_CST_Noctilus_&_OtherFactionVamp_&_Positive	0.0000
jiangshi_dlc11_diplomacy_Faction_CST_REBELLION_Male_&_OtherFactionVamp	dlc11_diplomacy_Faction_CST_REBELLION_Male_&_OtherFactionVamp	0.0000
jiangshi_dlc11_diplomacy_Faction_CST_REBELLION_Male_&_OtherFactionVamp_&_Negative	dlc11_diplomacy_Faction_CST_REBELLION_Male_&_OtherFactionVamp_&_Negative	0.0000
jiangshi_dlc11_diplomacy_Faction_CST_VFA_Male_&_OtherFactionVamp	dlc11_diplomacy_Faction_CST_VFA_Male_&_OtherFactionVamp	0.0000
jiangshi_dlc11_diplomacy_Faction_CST_VFA_Male_&_OtherFactionVamp_&_Negative	dlc11_diplomacy_Faction_CST_VFA_Male_&_OtherFactionVamp_&_Negative	0.0000
grn_faction_waaagh_reward_member_jiangshi	grn_faction_waaagh_reward_group_undead	0.0000
jiangshi_wh2_dlc11_diplomacy_Faction_CST_Aranessa_&_OtherFactionVamp	wh2_dlc11_diplomacy_Faction_CST_Aranessa_&_OtherFactionVamp	0.0000
jiangshi_wh2_dlc11_diplomacy_Faction_CST_Aranessa_&_OtherFactionVamp_&_Negative	wh2_dlc11_diplomacy_Faction_CST_Aranessa_&_OtherFactionVamp_&_Negative	0.0000
jiangshi_wh2_dlc11_diplomacy_Faction_CST_Aranessa_&_OtherFactionVamp_&_Positive	wh2_dlc11_diplomacy_Faction_CST_Aranessa_&_OtherFactionVamp_&_Positive	0.0000
jiangshi_wh2_dlc11_diplomacy_Faction_CST_Cylostra_&_OtherFactionVamp	wh2_dlc11_diplomacy_Faction_CST_Cylostra_&_OtherFactionVamp	0.0000
jiangshi_wh2_dlc11_diplomacy_Faction_CST_Cylostra_&_OtherFactionVamp_&_Negative	wh2_dlc11_diplomacy_Faction_CST_Cylostra_&_OtherFactionVamp_&_Negative	0.0000
jiangshi_wh2_dlc11_diplomacy_Faction_CST_Cylostra_&_OtherFactionVamp_&_Positive	wh2_dlc11_diplomacy_Faction_CST_Cylostra_&_OtherFactionVamp_&_Positive	0.0000
wh2_dlc15_hef_eltharion_dungeon_reward_jiangshi	wh2_dlc15_hef_eltharion_dungeon_reward_vampire_counts	0.0000
wh2_dlc15_prison_action_interrogate_jiangshi	wh2_dlc15_prison_action_interrogate_vampire_counts	0.0000
jiangshi_wh2_main_sc_vmp_vampire_counts_occupation_decision_colonise	wh2_main_sc_vmp_vampire_counts_occupation_decision_colonise	0.0000
jiangshi_wh2_main_sc_vmp_vampire_counts_occupation_decision_do_nothing	wh2_main_sc_vmp_vampire_counts_occupation_decision_do_nothing	0.0000
jiangshi_wh2_main_sc_vmp_vampire_counts_occupation_decision_loot	wh2_main_sc_vmp_vampire_counts_occupation_decision_loot	0.0000
jiangshi_wh2_main_sc_vmp_vampire_counts_occupation_decision_occupy	wh2_main_sc_vmp_vampire_counts_occupation_decision_occupy	0.0000
jiangshi_wh2_main_sc_vmp_vampire_counts_occupation_decision_raze_without_occupy	wh2_main_sc_vmp_vampire_counts_occupation_decision_raze_without_occupy	0.0000
jiangshi_wh2_main_sc_vmp_vampire_counts_occupation_decision_resettle	wh2_main_sc_vmp_vampire_counts_occupation_decision_resettle	0.0000
jiangshi_wh2_main_sc_vmp_vampire_counts_occupation_decision_sack	wh2_main_sc_vmp_vampire_counts_occupation_decision_sack	0.0000
jiangshi_wh2_main_sc_vmp_vampire_counts_occupation_decision_vassal	wh2_main_sc_vmp_vampire_counts_occupation_decision_vassal	0.0000
jiangshi_wh3_dlc20_chs_occuption_option_non_daemon_wh_main_vmp_vampire_counts	wh3_dlc20_occupation_decision_chaos_vs_non_daemon	0.0000
jiangshi_wh_dlc03_diplomacy_Faction_Khazrak_&_OtherFactionVamp	wh_dlc03_diplomacy_Faction_Khazrak_&_OtherFactionVamp	0.0000
jiangshi_wh_dlc03_diplomacy_Faction_Khazrak_&_OtherFactionVamp_&_Negative	wh_dlc03_diplomacy_Faction_Khazrak_&_OtherFactionVamp_&_Negative	0.0000
jiangshi_wh_dlc03_diplomacy_Faction_Khazrak_&_OtherFactionVamp_&_Positive	wh_dlc03_diplomacy_Faction_Khazrak_&_OtherFactionVamp_&_Positive	0.0000
jiangshi_wh_dlc03_diplomacy_Faction_Malagor_&_OtherFactionVamp	wh_dlc03_diplomacy_Faction_Malagor_&_OtherFactionVamp	0.0000
jiangshi_wh_dlc03_diplomacy_Faction_Malagor_&_OtherFactionVamp_&_Negative	wh_dlc03_diplomacy_Faction_Malagor_&_OtherFactionVamp_&_Negative	0.0000
jiangshi_wh_dlc03_diplomacy_Faction_Malagor_&_OtherFactionVamp_&_Positive	wh_dlc03_diplomacy_Faction_Malagor_&_OtherFactionVamp_&_Positive	0.0000
jiangshi_wh_dlc03_diplomacy_Subcult_Beastmen_&_OtherFactionVamp	wh_dlc03_diplomacy_Subcult_Beastmen_&_OtherFactionVamp	0.0000
jiangshi_wh_dlc03_diplomacy_Subcult_Beastmen_&_OtherFactionVamp_&_Negative	wh_dlc03_diplomacy_Subcult_Beastmen_&_OtherFactionVamp_&_Negative	0.0000
jiangshi_wh_dlc03_diplomacy_Subcult_Beastmen_&_OtherFactionVamp_&_Positive	wh_dlc03_diplomacy_Subcult_Beastmen_&_OtherFactionVamp_&_Positive	0.0000
jiangshi_wh_dlc05_diplomacy_Faction_Durthu_&_OtherFactionVamp	wh_dlc05_diplomacy_Faction_Durthu_&_OtherFactionVamp	0.0000
jiangshi_wh_dlc05_diplomacy_Faction_Durthu_&_OtherFactionVamp_&_Negative	wh_dlc05_diplomacy_Faction_Durthu_&_OtherFactionVamp_&_Negative	0.0000
jiangshi_wh_dlc05_diplomacy_Faction_Durthu_&_OtherFactionVamp_&_Positive	wh_dlc05_diplomacy_Faction_Durthu_&_OtherFactionVamp_&_Positive	0.0000
jiangshi_wh_dlc05_diplomacy_Faction_Orion_&_OtherFactionVamp	wh_dlc05_diplomacy_Faction_Orion_&_OtherFactionVamp	0.0000
jiangshi_wh_dlc05_diplomacy_Faction_Orion_&_OtherFactionVamp_&_Negative	wh_dlc05_diplomacy_Faction_Orion_&_OtherFactionVamp_&_Negative	0.0000
jiangshi_wh_dlc05_diplomacy_Faction_Orion_&_OtherFactionVamp_&_Positive	wh_dlc05_diplomacy_Faction_Orion_&_OtherFactionVamp_&_Positive	0.0000
jiangshi_wh_dlc05_diplomacy_Subcult_WoodElves_&_FactionGroup_WoodElf_FemGladeLord_1_&_OtherFactionVamp	wh_dlc05_diplomacy_Subcult_WoodElves_&_FactionGroup_WoodElf_FemGladeLord_1_&_OtherFactionVamp	0.0000
jiangshi_wh_dlc05_diplomacy_Subcult_WoodElves_&_FactionGroup_WoodElf_FemGladeLord_1_&_OtherFactionVamp_&_Negative	wh_dlc05_diplomacy_Subcult_WoodElves_&_FactionGroup_WoodElf_FemGladeLord_1_&_OtherFactionVamp_&_Negative	0.0000
jiangshi_wh_dlc05_diplomacy_Subcult_WoodElves_&_FactionGroup_WoodElf_FemGladeLord_1_&_OtherFactionVamp_&_Positive	wh_dlc05_diplomacy_Subcult_WoodElves_&_FactionGroup_WoodElf_FemGladeLord_1_&_OtherFactionVamp_&_Positive	0.0000
jiangshi_wh_dlc05_diplomacy_Subcult_WoodElves_&_OtherFactionVamp	wh_dlc05_diplomacy_Subcult_WoodElves_&_OtherFactionVamp	0.0000
jiangshi_wh_dlc05_diplomacy_Subcult_WoodElves_&_OtherFactionVamp_&_Negative	wh_dlc05_diplomacy_Subcult_WoodElves_&_OtherFactionVamp_&_Negative	0.0000
jiangshi_wh_dlc05_diplomacy_Subcult_WoodElves_&_OtherFactionVamp_&_Positive	wh_dlc05_diplomacy_Subcult_WoodElves_&_OtherFactionVamp_&_Positive	0.0000
jiangshi_wh_dlc07_diplomacy_Faction_Alberic_&_OtherFactionVamp	wh_dlc07_diplomacy_Faction_Alberic_&_OtherFactionVamp	0.0000
jiangshi_wh_dlc07_diplomacy_Faction_Alberic_&_OtherFactionVamp_&_Negative	wh_dlc07_diplomacy_Faction_Alberic_&_OtherFactionVamp_&_Negative	0.0000
jiangshi_wh_dlc07_diplomacy_Faction_Alberic_&_OtherFactionVamp_&_Positive	wh_dlc07_diplomacy_Faction_Alberic_&_OtherFactionVamp_&_Positive	0.0000
jiangshi_wh_dlc07_diplomacy_Faction_FayEnchantress_&_OtherFactionVamp	wh_dlc07_diplomacy_Faction_FayEnchantress_&_OtherFactionVamp	0.0000
jiangshi_wh_dlc07_diplomacy_Faction_FayEnchantress_&_OtherFactionVamp_&_Negative	wh_dlc07_diplomacy_Faction_FayEnchantress_&_OtherFactionVamp_&_Negative	0.0000
jiangshi_wh_dlc07_diplomacy_Faction_FayEnchantress_&_OtherFactionVamp_&_Positive	wh_dlc07_diplomacy_Faction_FayEnchantress_&_OtherFactionVamp_&_Positive	0.0000
jiangshi_wh_dlc08_diplomacy_Faction_Throgg_&_OtherFactionVamp	wh_dlc08_diplomacy_Faction_Throgg_&_OtherFactionVamp	0.0000
jiangshi_wh_dlc08_diplomacy_Faction_Throgg_&_OtherFactionVamp_&_Negative	wh_dlc08_diplomacy_Faction_Throgg_&_OtherFactionVamp_&_Negative	0.0000
jiangshi_wh_dlc08_diplomacy_Faction_Throgg_&_OtherFactionVamp_&_Positive	wh_dlc08_diplomacy_Faction_Throgg_&_OtherFactionVamp_&_Positive	0.0000
jiangshi_wh_dlc08_diplomacy_Faction_Wulfrik_&_OtherFactionVamp	wh_dlc08_diplomacy_Faction_Wulfrik_&_OtherFactionVamp	0.0000
jiangshi_wh_dlc08_diplomacy_Faction_Wulfrik_&_OtherFactionVamp_&_Negative	wh_dlc08_diplomacy_Faction_Wulfrik_&_OtherFactionVamp_&_Negative	0.0000
jiangshi_wh_dlc08_diplomacy_Faction_Wulfrik_&_OtherFactionVamp_&_Positive	wh_dlc08_diplomacy_Faction_Wulfrik_&_OtherFactionVamp_&_Positive	0.0000
jiangshi_wh_occupation_decision_bretonnia_raze_vampires	wh_main_occupation_decision_bretonnia_raze_enemy	0.0000
jiangshi_wh_occupation_decision_bretonnia_sack_vampires	wh_main_occupation_decision_bretonnia_sack_enemy	0.0000
